1111111111111111111111111111111111
1000100000000000000000000000000001
10E010000000C000100000000000010001
1000000000110000000000011000000001
111010000000000000000111100C000001
1000000000000000000000110100000001
1000001000000000000000000000000001
1000000000000000000000000000000001
1000000000010000011000000000000001
10000000010000000C000000000C000001
1000010C00000000000000000010000001
1000000000000000000000000000000001
1000000000000000001000C00000000001
1000000000100000001000000000000001
100000000101000000000000000C000001
1000000111000000000000000110000001
1000C00011000000000000011111100001
1000000000000000010000001110000001
100000000000000000000000000C000001
1000010000000C00000000000100000001
1000000000000000110000000000000P01
1000000000000000000000000000000001
1111111111111111111111111111111111