111111111111111111111
110101010101C10101011
10000C000000000000E01
110000000000010100011
1C00000C0000111110001
110000000000010100011
10000C000000111110001
110000000000010100011
1000000000C00C0000001
110001C10000000000011
1000111110000000000C1
110C01010000000C00011
100011111000000000001
110001010000C00000011
10P00000000000000C001
110101010101010101011
111111111111111111111