111111111111111111111
111111111111111111111
111111111111111111111
1111000000E0000C01111
11110C000000000001111
11110000000C000C01111
11110C000C00000C01111
111100000000000001111
1111000C00000C0001111
1111000000000000C1111
111100C000C0000C01111
111100C00000000001111
1111C00000P000C001111
111111111111111111111
111111111111111111111
111111111111111111111