11111111111111111111111111111111111111111111111111111111111
100000000000000000000000000000000000000000000000000000000C1
10000000000000000000000000C00000000C00000000001111111111101
100000000C0000000000000000000000000000000000001000000000101
100000000000000000000000C00000000000000000000010000E0000101
10000000000000000C00000000000000000000C00000001000000000101
100000000000000000000000000000000C0000000000001111000111101
10000000000000000000000000000000000000000000000000000000001
1000000C00000000000000011111100001110000C00000C000000000001
1000000000000000C00011111111111111111110000000000000C000001
10000000C00000001111111111111111111111111110000000000000001
1000000000000011111111111111111111111111111111000C000000001
10000000000000111111111111111111111111111111110000000000001
1000000000000011111111111111111111111111111111000000C000001
10000000C00000111111111111111111111111111111110000000000001
1000000000000011111111111111111111111111111111000C000000001
10000000000001111111111111111111111111111111000000000000001
10000000C0000111111111111111111111111111111100000000000C001
10000000000000111111111111111111111111111100000000000000001
10000000000000111111111111111111111111111000000000000000001
10000000000000000011111111111111111100000000000000000000001
10000000000000000C00000000000000000000000000C00000000000001
1000000000C0000000000000000000000000000000000000000000C0001
10000000000000000000000000000000C00000000000000000000000001
100000000000000000C0000000000000000000000000000000C00000001
10000000000000000000000000000000000000000000000000000000001
10000000000000000000000000000000000000000000000000000000001
11111111111111111111111111101111111111111111111111111111111
11111111111111111111111101101101111111111111111111111111111
11111111111111111111111101000101111111111111111111111111111
11111111111111111111111101101101111111111111111111111111111
11111111111111111111111101000101111111111111111111111111111
11111111111111111111111101101101111111111111111111111111111
11111111111111111111111101000101111111111111111111111111111
11111111111111111111111101101101111111111111111111111111111
11111111111111111111111101000101111111111111111111111111111
11111111111111111111111101101101111111111111111111111111111
11111111111111111111111111101111111111111111111111111111111
10000000000000000000000000000000000000000000000000000000001
10000000000000000000000000000000000000000000000000000000001
10000000000000000000000000000000000000000000000000000000001
100000000000000000000000000P0000000000000000000000000000001
11111111111111111111111111111111111111111111111111111111111
