1111111111111111111111111111111111
100C0000000000000010100000000000E1
1010010100100001101001000000010111
1010010010101010001001000000010101
100P000000000001000000000000000101
1111111111111111111111111111111111
1000000000000001000000000000000101
1111111111111111111111111111111111